contributors	Y	text
coordinates	N	text
created_at	Y	text
display_text_range	N	text
entities	Y	object
extended_entities	N	object
extended_tweet	Y	object
favorite_count	N	long
favorited	Y	boolean
filter_level	N	text
geo	Y	text
id	N	long
id_str	Y	text
in_reply_to_screen_name	N	text
in_reply_to_status_id	Y	text
in_reply_to_status_id_str	N	text
in_reply_to_user_id	Y	text
in_reply_to_user_id_str	N	text
is_quote_status	Y	boolean
lang	N	text
matching_rules	Y	text
place	N	text
possibly_sensitive	Y	boolean
quote_count	N	long
quoted_status	Y	object
quoted_status_id	N	long
quoted_status_id_str	Y	text
quoted_status_permalink	N	object
reply_count	Y	long
retweet_count	N	long
retweeted	Y	boolean
retweeted_status	N	object
source	Y	text
text	N	text
truncated	Y	boolean
user	N	object