contributors	N	object
coordinates	N	object
created_at	Y	text
display_text_range	N	object
entities	N	object
extended_entities	N	object
extended_tweet	N	object
favorite_count	Y	long
favorited	Y	boolean
filter_level	Y	text
geo	N	object
id	Y	long
id_str	Y	text
in_reply_to_screen_name	Y	text
in_reply_to_status_id	Y	text
in_reply_to_status_id_str	Y	text
in_reply_to_user_id	Y	text
in_reply_to_user_id_str	Y	text
is_quote_status	Y	boolean
lang	Y	text
matching_rules	N	object
place	N	object
possibly_sensitive	Y	boolean
quote_count	Y	long
quoted_status	N	object
quoted_status_id	Y	long
quoted_status_id_str	Y	text
quoted_status_permalink	N	object
reply_count	Y	long
retweet_count	Y	long
retweeted	Y	boolean
retweeted_status	N	object
source	Y	text
text	Y	text
truncated	Y	boolean
user	N	object
